111111111111111111111
1P000CCCC00CCCC000001
100C0000C00C000010C01
100100C0000C0000100C1
100100000000000111111
100100000011100100001
1001000E00C0000100C01
100100000CC11111000C1
10000000CC011100CC001
100011110111110000101
100000000C000C00C01C1
111111111111111111111